Date,Description,Amount Debit,Amount Credit,Balance
2023-10-01,"Initial Balance",,,1000.00
2023-10-05,"OFFICE DEPOT STORE #123",50.00,,950.00
2023-10-07,"Salary Deposit",,500.00,1450.00
2023-10-10,"ZOOM VIDEO COMMUNICATIONS",15.00,,1435.00
2023-10-12,"TRANSFER FROM SAVINGS",,200.00,1635.00
2023-10-15,"STAPLES #456",75.50,,1559.50
